Time,Balance Before,Balance After,Profit,Action
2022-08-14 19:01:32,1 275.23,1 283.12,+7.89,"Close short position for symbol BYBIT:APEUSDT at price 6.380 for 82.5 shares. Position AVG Price was 6.475571, currency: USDT, rate: 1.000190, last updated rate on 2022-08-14T16:31:02Z, point value: 1.000000"
2022-08-14 19:00:51,1 270.39,1 275.23,+4.84,"Close short position for symbol BYBIT:APEUSDT at price 6.411 for 75 shares. Position AVG Price was 6.475571, currency: USDT, rate: 1.000190, last updated rate on 2022-08-14T16:31:02Z, point value: 1.000000"
2022-08-14 18:56:10,1 265.12,1 270.39,+5.27,"Close short position for symbol BYBIT:APEUSDT at price 6.441 for 67.5 shares. Position AVG Price was 6.519000, currency: USDT, rate: 1.000190, last updated rate on 2022-08-14T16:31:02Z, point value: 1.000000"
2022-08-14 18:49:59,1 260.71,1 265.12,+4.41,"Close short position for symbol BYBIT:APEUSDT at price 6.467 for 45 shares. Position AVG Price was 6.565000, currency: USDT, rate: 1.000190, last updated rate on 2022-08-14T16:31:02Z, point value: 1.000000"
2022-08-14 18:47:56,1 252.97,1 260.71,+7.74,"Close short position for symbol BYBIT:APEUSDT at price 6.479 for 90 shares. Position AVG Price was 6.565000, currency: USDT, rate: 1.000190, last updated rate on 2022-08-14T16:31:02Z, point value: 1.000000"
2022-08-14 18:44:56,1 247.30,1 252.97,+5.67,"Close short position for symbol BYBIT:APEUSDT at price 6.533 for 90 shares. Position AVG Price was 6.596000, currency: USDT, rate: 1.000190, last updated rate on 2022-08-14T16:31:02Z, point value: 1.000000"
2022-08-14 18:37:10,1 250.18,1 247.30,-2.88,"Close long position for symbol BYBIT:APEUSDT at price 6.607 for 188 shares. Position AVG Price was 6.622340, currency: USDT, rate: 1.000190, last updated rate on 2022-08-14T16:31:02Z, point value: 1.000000"
2022-08-14 18:17:19,1 254.14,1 250.18,-3.96,"Close long position for symbol BYBIT:APEUSDT at price 6.608 for 180 shares. Position AVG Price was 6.630000, currency: USDT, rate: 1.000410, last updated rate on 2022-08-14T15:32:07Z, point value: 1.000000"
2022-08-14 18:15:36,1 254.68,1 254.14,-0.54,"Close short position for symbol BYBIT:APEUSDT at price 6.630 for 180 shares. Position AVG Price was 6.627000, currency: USDT, rate: 1.000410, last updated rate on 2022-08-14T15:32:07Z, point value: 1.000000"
2022-08-14 18:13:28,1 258.92,1 254.68,-4.23,"Close long position for symbol BYBIT:APEUSDT at price 6.629 for 180 shares. Position AVG Price was 6.652500, currency: USDT, rate: 1.000410, last updated rate on 2022-08-14T15:32:07Z, point value: 1.000000"
2022-08-14 18:11:59,1 258.56,1 258.92,+0.36,"Close short position for symbol BYBIT:APEUSDT at price 6.653 for 180 shares. Position AVG Price was 6.655000, currency: USDT, rate: 1.000410, last updated rate on 2022-08-14T15:32:07Z, point value: 1.000000"
2022-08-14 18:04:55,1 258.20,1 258.56,+0.36,"Close long position for symbol BYBIT:APEUSDT at price 6.655 for 180 shares. Position AVG Price was 6.653000, currency: USDT, rate: 1.000410, last updated rate on 2022-08-14T15:32:07Z, point value: 1.000000"
2022-08-14 17:38:03,1 262.16,1 258.20,-3.96,"Close short position for symbol BYBIT:APEUSDT at price 6.654 for 180 shares. Position AVG Price was 6.632000, currency: USDT, rate: 1.000410, last updated rate on 2022-08-14T15:32:07Z, point value: 1.000000"
2022-08-14 17:11:07,1 262.16,1 262.16,0.00,"Close long position for symbol BYBIT:APEUSDT at price 6.636 for 180 shares. Position AVG Price was 6.636000, currency: USDT, rate: 1.000410, last updated rate on 2022-08-14T14:31:06Z, point value: 1.000000"
2022-08-14 16:55:07,1 265.76,1 262.16,-3.60,"Close short position for symbol BYBIT:APEUSDT at price 6.632 for 180 shares. Position AVG Price was 6.612000, currency: USDT, rate: 1.000410, last updated rate on 2022-08-14T14:31:06Z, point value: 1.000000"
2022-08-14 16:48:31,1 268.91,1 265.76,-3.15,"Close long position for symbol BYBIT:APEUSDT at price 6.612 for 180 shares. Position AVG Price was 6.629500, currency: USDT, rate: 1.000410, last updated rate on 2022-08-14T14:31:06Z, point value: 1.000000"
2022-08-14 16:44:08,1 272.33,1 268.91,-3.42,"Close long position for symbol BYBIT:APEUSDT at price 6.624 for 180 shares. Position AVG Price was 6.643000, currency: USDT, rate: 1.000410, last updated rate on 2022-08-14T14:31:06Z, point value: 1.000000"
2022-08-14 16:30:00,1 275.39,1 272.33,-3.06,"Close long position for symbol BYBIT:APEUSDT at price 6.649 for 180 shares. Position AVG Price was 6.666000, currency: USDT, rate: 1.000190, last updated rate on 2022-08-14T13:32:43Z, point value: 1.000000"
2022-08-14 16:04:10,1 276.20,1 275.39,-0.81,"Close short position for symbol BYBIT:APEUSDT at price 6.666 for 180 shares. Position AVG Price was 6.661500, currency: USDT, rate: 1.000190, last updated rate on 2022-08-14T13:32:43Z, point value: 1.000000"
2022-08-14 15:56:47,1 276.29,1 276.20,-0.09,"Close long position for symbol BYBIT:APEUSDT at price 6.659 for 180 shares. Position AVG Price was 6.659500, currency: USDT, rate: 1.000190, last updated rate on 2022-08-14T13:32:43Z, point value: 1.000000"
2022-08-14 15:37:35,1 275.03,1 276.29,+1.26,"Close short position for symbol BYBIT:APEUSDT at price 6.650 for 90 shares. Position AVG Price was 6.664000, currency: USDT, rate: 1.000190, last updated rate on 2022-08-14T13:32:43Z, point value: 1.000000"
2022-08-14 15:32:35,1 274.13,1 275.03,+0.90,"Close short position for symbol BYBIT:APEUSDT at price 6.672 for 180 shares. Position AVG Price was 6.677000, currency: USDT, rate: 1.000200, last updated rate on 2022-08-14T12:31:54Z, point value: 1.000000"
2022-08-14 15:28:46,1 273.68,1 274.13,+0.45,"Close short position for symbol BYBIT:APEUSDT at price 6.675 for 180 shares. Position AVG Price was 6.677500, currency: USDT, rate: 1.000200, last updated rate on 2022-08-14T12:31:54Z, point value: 1.000000"
2022-08-14 15:26:47,1 269.09,1 273.68,+4.59,"Close short position for symbol BYBIT:APEUSDT at price 6.640 for 45 shares. Position AVG Price was 6.742000, currency: USDT, rate: 1.000200, last updated rate on 2022-08-14T12:31:54Z, point value: 1.000000"
2022-08-14 15:25:50,1 264.05,1 269.09,+5.04,"Close short position for symbol BYBIT:APEUSDT at price 6.686 for 90 shares. Position AVG Price was 6.742000, currency: USDT, rate: 1.000200, last updated rate on 2022-08-14T12:31:54Z, point value: 1.000000"
2022-08-14 15:11:06,1 266.57,1 264.05,-2.52,"Close long position for symbol BYBIT:APEUSDT at price 6.742 for 180 shares. Position AVG Price was 6.756000, currency: USDT, rate: 1.000200, last updated rate on 2022-08-14T12:31:54Z, point value: 1.000000"
2022-08-14 13:58:07,1 266.20,1 266.57,+0.37,"Close short position for symbol BYBIT:MATICUSDT at price 1.0253 for 1220 shares. Position AVG Price was 1.025600, currency: USDT, rate: 1.000200, last updated rate on 2022-08-14T11:31:56Z, point value: 1.000000"
2022-08-14 13:41:41,1 261.87,1 266.20,+4.33,"Close short position for symbol BYBIT:MATICUSDT at price 1.0216 for 610 shares. Position AVG Price was 1.028700, currency: USDT, rate: 1.000200, last updated rate on 2022-08-14T11:31:56Z, point value: 1.000000"
2022-08-14 13:29:42,1 265.53,1 261.87,-3.66,"Close short position for symbol BYBIT:MATICUSDT at price 1.0297 for 1220 shares. Position AVG Price was 1.026700, currency: USDT, rate: 1.000450, last updated rate on 2022-08-14T10:28:50Z, point value: 1.000000"
2022-08-14 12:37:17,1 266.39,1 265.53,-0.85,"Close long position for symbol BYBIT:MATICUSDT at price 1.0267 for 1220 shares. Position AVG Price was 1.027400, currency: USDT, rate: 1.000450, last updated rate on 2022-08-14T10:28:50Z, point value: 1.000000"
2022-08-14 12:27:35,1 264.92,1 266.39,+1.46,"Close short position for symbol BYBIT:MATICUSDT at price 1.0274 for 1220 shares. Position AVG Price was 1.028600, currency: USDT, rate: 1.000250, last updated rate on 2022-08-14T09:32:38Z, point value: 1.000000"
2022-08-14 12:15:31,1 265.72,1 264.92,-0.79,"Close long position for symbol BYBIT:MATICUSDT at price 1.0286 for 1220 shares. Position AVG Price was 1.029250, currency: USDT, rate: 1.000250, last updated rate on 2022-08-14T09:32:38Z, point value: 1.000000"
2022-08-14 12:14:10,1 267.55,1 265.72,-1.83,"Close short position for symbol BYBIT:MATICUSDT at price 1.0292 for 610 shares. Position AVG Price was 1.026200, currency: USDT, rate: 1.000250, last updated rate on 2022-08-14T09:32:38Z, point value: 1.000000"
2022-08-14 12:12:33,1 270.17,1 267.55,-2.62,"Close long position for symbol BYBIT:MATICUSDT at price 1.0262 for 1220 shares. Position AVG Price was 1.028350, currency: USDT, rate: 1.000250, last updated rate on 2022-08-14T09:32:38Z, point value: 1.000000"
2022-08-14 12:07:25,1 270.41,1 270.17,-0.24,"Close short position for symbol BYBIT:MATICUSDT at price 1.0292 for 610 shares. Position AVG Price was 1.028800, currency: USDT, rate: 1.000250, last updated rate on 2022-08-14T09:32:38Z, point value: 1.000000"
2022-08-14 12:06:35,1 272.67,1 270.41,-2.26,"Close long position for symbol BYBIT:MATICUSDT at price 1.0288 for 610 shares. Position AVG Price was 1.032500, currency: USDT, rate: 1.000250, last updated rate on 2022-08-14T09:32:38Z, point value: 1.000000"
2022-08-14 11:58:31,1 272.43,1 272.67,+0.24,"Close long position for symbol BYBIT:MATICUSDT at price 1.0318 for 610 shares. Position AVG Price was 1.031400, currency: USDT, rate: 1.000250, last updated rate on 2022-08-14T09:32:38Z, point value: 1.000000"
2022-08-14 11:48:34,1 272.31,1 272.43,+0.12,"Close short position for symbol BYBIT:MATICUSDT at price 1.0314 for 610 shares. Position AVG Price was 1.031600, currency: USDT, rate: 1.000250, last updated rate on 2022-08-14T09:32:38Z, point value: 1.000000"
2022-08-13 17:59:43,1 267.30,1 272.31,+5.00,"Close short position for symbol BYBIT:APEUSDT at price 6.888 for 1500 shares. Position AVG Price was 6.891333, currency: USDT, rate: 1.000490, last updated rate on 2022-08-13T15:27:28Z, point value: 1.000000"
2022-08-13 17:53:20,1 259.90,1 267.30,+7.40,"Close short position for symbol BYBIT:APEUSDT at price 6.885 for 2180 shares. Position AVG Price was 6.888394, currency: USDT, rate: 1.000490, last updated rate on 2022-08-13T15:27:28Z, point value: 1.000000"
2022-08-13 17:03:37,1 263.34,1 259.90,-3.44,"Close short position for symbol BYBIT:APEUSDT at price 6.887 for 160 shares. Position AVG Price was 6.865500, currency: USDT, rate: 1.000300, last updated rate on 2022-08-13T14:32:34Z, point value: 1.000000"
2022-08-13 16:48:30,1 265.90,1 263.34,-2.56,"Close short position for symbol BYBIT:APEUSDT at price 6.874 for 160 shares. Position AVG Price was 6.858000, currency: USDT, rate: 1.000300, last updated rate on 2022-08-13T14:32:34Z, point value: 1.000000"
2022-08-13 16:43:50,1 267.42,1 265.90,-1.52,"Close long position for symbol BYBIT:APEUSDT at price 6.858 for 160 shares. Position AVG Price was 6.867500, currency: USDT, rate: 1.000300, last updated rate on 2022-08-13T14:32:34Z, point value: 1.000000"
2022-08-13 15:45:45,1 268.62,1 267.42,-1.20,"Close long position for symbol BYBIT:APEUSDT at price 6.864 for 160 shares. Position AVG Price was 6.871500, currency: USDT, rate: 1.000450, last updated rate on 2022-08-13T13:32:26Z, point value: 1.000000"
2022-08-13 15:41:18,1 271.42,1 268.62,-2.80,"Close short position for symbol BYBIT:APEUSDT at price 6.882 for 160 shares. Position AVG Price was 6.864500, currency: USDT, rate: 1.000450, last updated rate on 2022-08-13T13:32:26Z, point value: 1.000000"
2022-08-13 14:19:10,1 275.27,1 271.42,-3.84,"Close long position for symbol BYBIT:APEUSDT at price 6.850 for 160 shares. Position AVG Price was 6.874000, currency: USDT, rate: 1.000570, last updated rate on 2022-08-13T11:30:48Z, point value: 1.000000"
2022-08-13 13:53:05,1 280.31,1 275.27,-5.04,"Close short position for symbol BYBIT:APEUSDT at price 6.876 for 160 shares. Position AVG Price was 6.844500, currency: USDT, rate: 1.000570, last updated rate on 2022-08-13T11:30:48Z, point value: 1.000000"
2022-08-13 13:30:06,1 280.31,1 280.31,0.00,"Close short position for symbol BYBIT:AVAXUSDT at price 29.510 for 42 shares. Position AVG Price was 29.510000, currency: USDT, rate: 1.000650, last updated rate on 2022-08-13T10:31:01Z, point value: 1.000000"
2022-08-13 13:16:56,1 280.52,1 280.31,-0.21,"Close short position for symbol BYBIT:AVAXUSDT at price 29.520 for 42 shares. Position AVG Price was 29.515000, currency: USDT, rate: 1.000650, last updated rate on 2022-08-13T10:31:01Z, point value: 1.000000"
2022-08-13 13:00:20,1 280.52,1 280.52,0.00,"Close short position for symbol BYBIT:AVAXUSDT at price 29.555 for 42 shares. Position AVG Price was 29.555000, currency: USDT, rate: 1.000650, last updated rate on 2022-08-13T10:31:01Z, point value: 1.000000"
2022-08-13 12:36:01,1 280.94,1 280.52,-0.42,"Close long position for symbol BYBIT:AVAXUSDT at price 29.575 for 21 shares. Position AVG Price was 29.595000, currency: USDT, rate: 1.000650, last updated rate on 2022-08-13T10:31:01Z, point value: 1.000000"
2022-08-13 12:35:01,1 280.94,1 280.94,0.00,"Close short position for symbol BYBIT:AVAXUSDT at price 29.580 for 42 shares. Position AVG Price was 29.580000, currency: USDT, rate: 1.000650, last updated rate on 2022-08-13T10:31:01Z, point value: 1.000000"
2022-08-13 12:07:40,1 281.04,1 280.94,-0.11,"Close long position for symbol BYBIT:AVAXUSDT at price 29.640 for 21 shares. Position AVG Price was 29.645000, currency: USDT, rate: 1.000620, last updated rate on 2022-08-13T09:32:33Z, point value: 1.000000"
2022-08-13 11:57:30,1 281.46,1 281.04,-0.42,"Close short position for symbol BYBIT:AVAXUSDT at price 29.645 for 21 shares. Position AVG Price was 29.625000, currency: USDT, rate: 1.000620, last updated rate on 2022-08-13T09:32:33Z, point value: 1.000000"
2022-08-13 11:49:40,1 281.46,1 281.46,0.00,"Close long position for symbol BYBIT:AVAXUSDT at price 29.625 for 21 shares. Position AVG Price was 29.625000, currency: USDT, rate: 1.000620, last updated rate on 2022-08-13T09:32:33Z, point value: 1.000000"
2022-08-13 11:07:37,1 279.17,1 281.46,+2.29,"Close short position for symbol BYBIT:APEUSDT at price 6.925 for 60 shares. Position AVG Price was 6.963167, currency: USDT, rate: 1.000350, last updated rate on 2022-08-13T08:30:50Z, point value: 1.000000"
2022-08-13 11:02:23,1 276.58,1 279.17,+2.59,"Close short position for symbol BYBIT:APEUSDT at price 6.920 for 60 shares. Position AVG Price was 6.963167, currency: USDT, rate: 1.000350, last updated rate on 2022-08-13T08:30:50Z, point value: 1.000000"
2022-08-13 10:54:37,1 273.64,1 276.58,+2.94,"Close short position for symbol BYBIT:APEUSDT at price 6.944 for 40 shares. Position AVG Price was 7.017500, currency: USDT, rate: 1.000350, last updated rate on 2022-08-13T08:30:50Z, point value: 1.000000"
2022-08-13 10:48:27,1 269.52,1 273.64,+4.12,"Close short position for symbol BYBIT:APEUSDT at price 6.966 for 80 shares. Position AVG Price was 7.017500, currency: USDT, rate: 1.000350, last updated rate on 2022-08-13T08:30:50Z, point value: 1.000000"
2022-08-13 10:30:34,1 271.92,1 269.52,-2.40,"Close short position for symbol BYBIT:APEUSDT at price 7.025 for 160 shares. Position AVG Price was 7.010000, currency: USDT, rate: 1.000560, last updated rate on 2022-08-13T07:32:09Z, point value: 1.000000"
2022-08-13 10:19:21,1 275.12,1 271.92,-3.20,"Close long position for symbol BYBIT:APEUSDT at price 7.010 for 160 shares. Position AVG Price was 7.030000, currency: USDT, rate: 1.000560, last updated rate on 2022-08-13T07:32:09Z, point value: 1.000000"
2022-08-13 10:17:37,1 276.80,1 275.12,-1.68,"Close short position for symbol BYBIT:APEUSDT at price 7.030 for 160 shares. Position AVG Price was 7.019500, currency: USDT, rate: 1.000560, last updated rate on 2022-08-13T07:32:09Z, point value: 1.000000"
2022-08-13 10:13:12,1 280.65,1 276.80,-3.84,"Close short position for symbol BYBIT:APEUSDT at price 7.024 for 160 shares. Position AVG Price was 7.000000, currency: USDT, rate: 1.000560, last updated rate on 2022-08-13T07:32:09Z, point value: 1.000000"
2022-08-12 16:39:26,1 279.54,1 280.65,+1.10,"Close long position for symbol BYBIT:AVAXUSDT at price 28.935 for 21 shares. Position AVG Price was 28.882500, currency: USDT, rate: 1.000590, last updated rate on 2022-08-12T14:29:43Z, point value: 1.000000"
2022-08-12 16:34:02,1 275.50,1 279.54,+4.04,"Close long position for symbol BYBIT:AVAXUSDT at price 29.075 for 21 shares. Position AVG Price was 28.882500, currency: USDT, rate: 1.000590, last updated rate on 2022-08-12T14:29:43Z, point value: 1.000000"
2022-08-12 16:23:02,1 270.98,1 275.50,+4.52,"Close long position for symbol BYBIT:AVAXUSDT at price 29.020 for 21 shares. Position AVG Price was 28.805000, currency: USDT, rate: 1.000620, last updated rate on 2022-08-12T13:31:38Z, point value: 1.000000"
2022-08-12 16:18:49,1 273.92,1 270.98,-2.94,"Close short position for symbol BYBIT:AVAXUSDT at price 28.805 for 42 shares. Position AVG Price was 28.735000, currency: USDT, rate: 1.000620, last updated rate on 2022-08-12T13:31:38Z, point value: 1.000000"
2022-08-12 16:16:02,1 274.13,1 273.92,-0.21,"Close long position for symbol BYBIT:AVAXUSDT at price 28.735 for 42 shares. Position AVG Price was 28.740000, currency: USDT, rate: 1.000620, last updated rate on 2022-08-12T13:31:38Z, point value: 1.000000"
2022-08-12 16:08:03,1 276.76,1 274.13,-2.63,"Close short position for symbol BYBIT:AVAXUSDT at price 28.685 for 42 shares. Position AVG Price was 28.622500, currency: USDT, rate: 1.000620, last updated rate on 2022-08-12T13:31:38Z, point value: 1.000000"
2022-08-12 16:04:35,1 274.87,1 276.76,+1.89,"Close short position for symbol BYBIT:AVAXUSDT at price 28.670 for 42 shares. Position AVG Price was 28.715000, currency: USDT, rate: 1.000620, last updated rate on 2022-08-12T13:31:38Z, point value: 1.000000"
2022-08-12 15:54:43,1 278.65,1 274.87,-3.78,"Close long position for symbol BYBIT:AVAXUSDT at price 28.745 for 42 shares. Position AVG Price was 28.835000, currency: USDT, rate: 1.000620, last updated rate on 2022-08-12T13:31:38Z, point value: 1.000000"
2022-08-12 15:50:46,1 281.07,1 278.65,-2.42,"Close short position for symbol BYBIT:AVAXUSDT at price 28.830 for 21 shares. Position AVG Price was 28.715000, currency: USDT, rate: 1.000620, last updated rate on 2022-08-12T13:31:38Z, point value: 1.000000"
2022-08-12 15:50:24,1 281.80,1 281.07,-0.74,"Close long position for symbol BYBIT:AVAXUSDT at price 28.715 for 21 shares. Position AVG Price was 28.750000, currency: USDT, rate: 1.000620, last updated rate on 2022-08-12T13:31:38Z, point value: 1.000000"
2022-08-12 14:07:54,1 283.80,1 281.80,-2.00,"Close short position for symbol BYBIT:AVAXUSDT at price 28.465 for 21 shares. Position AVG Price was 28.370000, currency: USDT, rate: 1.000550, last updated rate on 2022-08-12T11:32:38Z, point value: 1.000000"
2022-08-12 13:31:46,1 281.49,1 283.80,+2.31,"Close short position for symbol BYBIT:AVAXUSDT at price 28.425 for 21 shares. Position AVG Price was 28.535000, currency: USDT, rate: 1.000360, last updated rate on 2022-08-12T10:27:45Z, point value: 1.000000"
2022-08-12 13:30:24,1 279.39,1 281.49,+2.10,"Close short position for symbol BYBIT:AVAXUSDT at price 28.435 for 21 shares. Position AVG Price was 28.535000, currency: USDT, rate: 1.000360, last updated rate on 2022-08-12T10:27:45Z, point value: 1.000000"
2022-08-12 13:01:36,1 281.80,1 279.39,-2.42,"Close short position for symbol BYBIT:AVAXUSDT at price 28.500 for 21 shares. Position AVG Price was 28.385000, currency: USDT, rate: 1.000360, last updated rate on 2022-08-12T10:27:45Z, point value: 1.000000"
2022-08-12 12:58:40,1 280.54,1 281.80,+1.26,"Close short position for symbol BYBIT:AVAXUSDT at price 28.440 for 21 shares. Position AVG Price was 28.500000, currency: USDT, rate: 1.000360, last updated rate on 2022-08-12T10:27:45Z, point value: 1.000000"
2022-08-12 12:54:54,1 278.98,1 280.54,+1.56,"Close short position for symbol BYBIT:AVAXUSDT at price 28.550 for 16 shares. Position AVG Price was 28.647715, currency: USDT, rate: 1.000360, last updated rate on 2022-08-12T10:27:45Z, point value: 1.000000"
2022-08-12 12:53:19,1 276.69,1 278.98,+2.28,"Close short position for symbol BYBIT:AVAXUSDT at price 28.505 for 16 shares. Position AVG Price was 28.647715, currency: USDT, rate: 1.000360, last updated rate on 2022-08-12T10:27:45Z, point value: 1.000000"
2022-08-12 12:42:13,1 274.74,1 276.69,+1.96,"Close short position for symbol BYBIT:AVAXUSDT at price 28.610 for 10 shares. Position AVG Price was 28.805625, currency: USDT, rate: 1.000360, last updated rate on 2022-08-12T10:27:45Z, point value: 1.000000"
2022-08-12 12:28:58,1 271.05,1 274.74,+3.69,"Close short position for symbol BYBIT:AVAXUSDT at price 28.630 for 21 shares. Position AVG Price was 28.805625, currency: USDT, rate: 1.000380, last updated rate on 2022-08-12T09:28:10Z, point value: 1.000000"
2022-08-12 12:19:54,1 268.08,1 271.05,+2.97,"Close short position for symbol BYBIT:AVAXUSDT at price 28.735 for 21 shares. Position AVG Price was 28.876250, currency: USDT, rate: 1.000380, last updated rate on 2022-08-12T09:28:10Z, point value: 1.000000"
2022-08-12 12:11:18,1 264.46,1 268.08,+3.62,"Close short position for symbol BYBIT:AVAXUSDT at price 28.765 for 21 shares. Position AVG Price was 28.937500, currency: USDT, rate: 1.000380, last updated rate on 2022-08-12T09:28:10Z, point value: 1.000000"
2022-08-12 12:03:30,1 266.45,1 264.46,-2.00,"Close long position for symbol BYBIT:AVAXUSDT at price 28.945 for 21 shares. Position AVG Price was 29.040000, currency: USDT, rate: 1.000380, last updated rate on 2022-08-12T09:28:10Z, point value: 1.000000"
2022-08-12 12:01:24,1 269.18,1 266.45,-2.73,"Close short position for symbol BYBIT:AVAXUSDT at price 29.035 for 42 shares. Position AVG Price was 28.970000, currency: USDT, rate: 1.000380, last updated rate on 2022-08-12T09:28:10Z, point value: 1.000000"
2022-08-12 11:58:41,1 272.97,1 269.18,-3.78,"Close long position for symbol BYBIT:AVAXUSDT at price 28.955 for 42 shares. Position AVG Price was 29.045000, currency: USDT, rate: 1.000380, last updated rate on 2022-08-12T09:28:10Z, point value: 1.000000"
2022-08-12 11:45:54,1 275.91,1 272.97,-2.94,"Close long position for symbol BYBIT:AVAXUSDT at price 28.990 for 42 shares. Position AVG Price was 29.060000, currency: USDT, rate: 1.000380, last updated rate on 2022-08-12T09:28:10Z, point value: 1.000000"
2022-08-11 16:19:15,1 275.06,1 275.91,+0.85,"Close long position for symbol BYBIT:MATICUSDT at price 0.9445 for 315 shares. Position AVG Price was 0.941800, currency: USDT, rate: 1.000660, last updated rate on 2022-08-11T13:31:38Z, point value: 1.000000"
2022-08-11 16:09:20,1 273.48,1 275.06,+1.58,"Close long position for symbol BYBIT:MATICUSDT at price 0.9468 for 315 shares. Position AVG Price was 0.941800, currency: USDT, rate: 1.000660, last updated rate on 2022-08-11T13:31:38Z, point value: 1.000000"
2022-08-11 16:03:10,1 271.46,1 273.48,+2.02,"Close long position for symbol BYBIT:MATICUSDT at price 0.9450 for 630 shares. Position AVG Price was 0.941800, currency: USDT, rate: 1.000660, last updated rate on 2022-08-11T13:31:38Z, point value: 1.000000"
2022-08-11 15:49:40,1 273.61,1 271.46,-2.14,"Close long position for symbol BYBIT:MATICUSDT at price 0.9418 for 1260 shares. Position AVG Price was 0.943500, currency: USDT, rate: 1.000660, last updated rate on 2022-08-11T13:31:38Z, point value: 1.000000"
2022-08-11 14:57:32,1 273.20,1 273.61,+0.40,"Close long position for symbol BYBIT:APEUSDT at price 7.113 for 80 shares. Position AVG Price was 7.108000, currency: USDT, rate: 1.000400, last updated rate on 2022-08-11T12:32:27Z, point value: 1.000000"
2022-08-11 14:42:23,1 273.08,1 273.20,+0.12,"Close long position for symbol BYBIT:APEUSDT at price 7.102 for 40 shares. Position AVG Price was 7.099000, currency: USDT, rate: 1.000400, last updated rate on 2022-08-11T12:32:27Z, point value: 1.000000"
2022-08-11 14:37:39,1 272.40,1 273.08,+0.68,"Close long position for symbol BYBIT:APEUSDT at price 7.116 for 40 shares. Position AVG Price was 7.099000, currency: USDT, rate: 1.000400, last updated rate on 2022-08-11T12:32:27Z, point value: 1.000000"
2022-08-11 14:31:49,1 270.52,1 272.40,+1.88,"Close long position for symbol BYBIT:APEUSDT at price 7.144 for 80 shares. Position AVG Price was 7.120500, currency: USDT, rate: 1.000550, last updated rate on 2022-08-11T11:32:18Z, point value: 1.000000"
2022-08-11 14:31:36,1 270.80,1 270.52,-0.28,"Close long position for symbol BYBIT:APEUSDT at price 7.117 for 80 shares. Position AVG Price was 7.120500, currency: USDT, rate: 1.000550, last updated rate on 2022-08-11T11:32:18Z, point value: 1.000000"
2022-08-11 14:17:16,1 270.24,1 270.80,+0.56,"Close long position for symbol BYBIT:APEUSDT at price 7.106 for 80 shares. Position AVG Price was 7.099000, currency: USDT, rate: 1.000550, last updated rate on 2022-08-11T11:32:18Z, point value: 1.000000"
2022-08-11 13:06:40,1 268.16,1 270.24,+2.08,"Close short position for symbol BYBIT:APEUSDT at price 7.065 for 40 shares. Position AVG Price was 7.117000, currency: USDT, rate: 1.000590, last updated rate on 2022-08-11T10:28:37Z, point value: 1.000000"
2022-08-11 12:43:46,1 264.16,1 268.16,+4.00,"Close short position for symbol BYBIT:APEUSDT at price 7.017 for 40 shares. Position AVG Price was 7.117000, currency: USDT, rate: 1.000590, last updated rate on 2022-08-11T10:28:37Z, point value: 1.000000"
2022-08-11 12:10:49,1 259.04,1 264.16,+5.12,"Close short position for symbol BYBIT:APEUSDT at price 7.053 for 80 shares. Position AVG Price was 7.117000, currency: USDT, rate: 1.000360, last updated rate on 2022-08-11T09:24:28Z, point value: 1.000000"
2022-08-11 11:38:32,1 258.96,1 259.04,+0.08,"Close short position for symbol BYBIT:APEUSDT at price 7.130 for 160 shares. Position AVG Price was 7.130500, currency: USDT, rate: 1.000360, last updated rate on 2022-08-11T09:24:28Z, point value: 1.000000"
2022-08-11 09:34:32,1 258.80,1 258.96,+0.16,"Close long position for symbol BYBIT:APEUSDT at price 7.203 for 80 shares. Position AVG Price was 7.201000, currency: USDT, rate: 1.000360, last updated rate on 2022-08-11T07:32:05Z, point value: 1.000000"
2022-08-11 09:27:18,1 258.40,1 258.80,+0.40,"Close long position for symbol BYBIT:APEUSDT at price 7.203 for 160 shares. Position AVG Price was 7.200500, currency: USDT, rate: 1.000360, last updated rate on 2022-08-11T06:32:03Z, point value: 1.000000"
2022-08-11 09:21:02,1 254.40,1 258.40,+4.00,"Close long position for symbol BYBIT:APEUSDT at price 7.240 for 80 shares. Position AVG Price was 7.190000, currency: USDT, rate: 1.000360, last updated rate on 2022-08-11T06:32:03Z, point value: 1.000000"
2022-08-10 20:31:48,1 249.91,1 254.40,+4.48,"Close short position for symbol BYBIT:APEUSDT at price 7.045 for 120 shares. Position AVG Price was 7.082333, currency: USDT, rate: 1.000340, last updated rate on 2022-08-10T17:32:31Z, point value: 1.000000"
2022-08-10 20:20:41,1 246.83,1 249.91,+3.08,"Close short position for symbol BYBIT:APEUSDT at price 7.058 for 40 shares. Position AVG Price was 7.135000, currency: USDT, rate: 1.000340, last updated rate on 2022-08-10T17:32:31Z, point value: 1.000000"
2022-08-10 19:26:21,1 250.03,1 246.83,-3.20,"Close short position for symbol BYBIT:APEUSDT at price 7.137 for 160 shares. Position AVG Price was 7.117000, currency: USDT, rate: 1.000350, last updated rate on 2022-08-10T16:21:10Z, point value: 1.000000"
2022-08-10 19:10:54,1 250.03,1 250.03,0.00,"Close long position for symbol BYBIT:APEUSDT at price 7.111 for 80 shares. Position AVG Price was 7.111000, currency: USDT, rate: 1.000350, last updated rate on 2022-08-10T16:21:10Z, point value: 1.000000"
2022-08-10 19:10:15,1 249.47,1 250.03,+0.56,"Close short position for symbol BYBIT:APEUSDT at price 7.111 for 80 shares. Position AVG Price was 7.118000, currency: USDT, rate: 1.000350, last updated rate on 2022-08-10T16:21:10Z, point value: 1.000000"
2022-08-10 19:06:15,1 246.59,1 249.47,+2.88,"Close short position for symbol BYBIT:APEUSDT at price 7.082 for 80 shares. Position AVG Price was 7.118000, currency: USDT, rate: 1.000350, last updated rate on 2022-08-10T16:21:10Z, point value: 1.000000"
2022-08-10 18:40:30,1 245.95,1 246.59,+0.64,"Close long position for symbol BYBIT:APEUSDT at price 7.118 for 160 shares. Position AVG Price was 7.114000, currency: USDT, rate: 1.000350, last updated rate on 2022-08-10T16:21:10Z, point value: 1.000000"
2022-08-10 18:38:40,1 245.63,1 245.95,+0.32,"Close short position for symbol BYBIT:APEUSDT at price 7.114 for 160 shares. Position AVG Price was 7.116000, currency: USDT, rate: 1.000350, last updated rate on 2022-08-10T16:21:10Z, point value: 1.000000"
2022-08-10 18:35:29,1 247.55,1 245.63,-1.92,"Close long position for symbol BYBIT:APEUSDT at price 7.116 for 160 shares. Position AVG Price was 7.128000, currency: USDT, rate: 1.000350, last updated rate on 2022-08-10T16:21:10Z, point value: 1.000000"
2022-08-10 18:34:02,1 246.27,1 247.55,+1.28,"Close short position for symbol BYBIT:APEUSDT at price 7.128 for 160 shares. Position AVG Price was 7.136000, currency: USDT, rate: 1.000350, last updated rate on 2022-08-10T16:21:10Z, point value: 1.000000"
2022-08-10 18:31:48,1 250.43,1 246.27,-4.16,"Close long position for symbol BYBIT:APEUSDT at price 7.137 for 160 shares. Position AVG Price was 7.163000, currency: USDT, rate: 1.000300, last updated rate on 2022-08-10T15:26:37Z, point value: 1.000000"
2022-08-10 16:01:19,1 237.31,1 250.43,+13.13,"Close short position for symbol BYBIT:APEUSDT at price 7.130 for 2720 shares. Position AVG Price was 7.134824, currency: USDT, rate: 1.000740, last updated rate on 2022-08-10T13:28:32Z, point value: 1.000000"
2022-08-10 15:21:05,1 234.00,1 237.31,+3.31,"Close long position for symbol BYBIT:APEUSDT at price 7.153 for 160 shares. Position AVG Price was 7.132333, currency: USDT, rate: 1.000210, last updated rate on 2022-08-10T12:06:07Z, point value: 1.000000"
2022-08-10 15:21:04,1 232.34,1 234.00,+1.65,"Close long position for symbol BYBIT:APEUSDT at price 7.153 for 80 shares. Position AVG Price was 7.132333, currency: USDT, rate: 1.000210, last updated rate on 2022-08-10T12:06:07Z, point value: 1.000000"
2022-08-10 15:20:58,1 230.85,1 232.34,+1.49,"Close long position for symbol BYBIT:APEUSDT at price 7.151 for 80 shares. Position AVG Price was 7.132333, currency: USDT, rate: 1.000210, last updated rate on 2022-08-10T12:06:07Z, point value: 1.000000"
2022-08-10 15:20:12,1 228.02,1 230.85,+2.83,"Close long position for symbol BYBIT:APEUSDT at price 7.150 for 160 shares. Position AVG Price was 7.132333, currency: USDT, rate: 1.000210, last updated rate on 2022-08-10T12:06:07Z, point value: 1.000000"
2022-08-10 15:19:22,1 234.82,1 228.02,-6.80,"Close short position for symbol BYBIT:APEUSDT at price 7.126 for 80 shares. Position AVG Price was 7.041000, currency: USDT, rate: 1.000210, last updated rate on 2022-08-10T12:06:07Z, point value: 1.000000"
2022-08-10 15:19:13,1 240.27,1 234.82,-5.44,"Close short position for symbol BYBIT:APEUSDT at price 7.109 for 80 shares. Position AVG Price was 7.041000, currency: USDT, rate: 1.000210, last updated rate on 2022-08-10T12:06:07Z, point value: 1.000000"
2022-08-10 13:05:14,1 239.07,1 240.27,+1.20,"Close short position for symbol BYBIT:APEUSDT at price 6.754 for 80 shares. Position AVG Price was 6.769000, currency: USDT, rate: 1.000300, last updated rate on 2022-08-10T10:06:03Z, point value: 1.000000"
2022-08-10 12:51:12,1 236.58,1 239.07,+2.48,"Close short position for symbol BYBIT:APEUSDT at price 6.738 for 80 shares. Position AVG Price was 6.769000, currency: USDT, rate: 1.000300, last updated rate on 2022-08-10T10:06:03Z, point value: 1.000000"
2022-08-10 11:59:34,1 241.15,1 236.58,-4.56,"Close short position for symbol BYBIT:APEUSDT at price 6.786 for 160 shares. Position AVG Price was 6.757500, currency: USDT, rate: 1.000280, last updated rate on 2022-08-10T09:04:00Z, point value: 1.000000"
2022-08-10 11:47:55,1 243.31,1 241.15,-2.16,"Close short position for symbol BYBIT:APEUSDT at price 6.758 for 160 shares. Position AVG Price was 6.744500, currency: USDT, rate: 1.000280, last updated rate on 2022-08-10T09:04:00Z, point value: 1.000000"
2022-08-10 11:31:31,1 242.11,1 243.31,+1.20,"Close short position for symbol BYBIT:APEUSDT at price 6.761 for 160 shares. Position AVG Price was 6.768500, currency: USDT, rate: 1.000280, last updated rate on 2022-08-10T09:04:00Z, point value: 1.000000"
2022-08-10 11:17:48,1 244.99,1 242.11,-2.88,"Close short position for symbol BYBIT:APEUSDT at price 6.783 for 160 shares. Position AVG Price was 6.765000, currency: USDT, rate: 1.000280, last updated rate on 2022-08-10T09:04:00Z, point value: 1.000000"
2022-08-10 11:04:03,1 244.51,1 244.99,+0.48,"Close short position for symbol BYBIT:APEUSDT at price 6.784 for 80 shares. Position AVG Price was 6.790000, currency: USDT, rate: 1.000160, last updated rate on 2022-08-10T08:07:00Z, point value: 1.000000"
2022-08-10 10:51:20,1 242.43,1 244.51,+2.08,"Close long position for symbol BYBIT:APEUSDT at price 6.781 for 40 shares. Position AVG Price was 6.729000, currency: USDT, rate: 1.000160, last updated rate on 2022-08-10T08:07:00Z, point value: 1.000000"
2022-08-10 10:50:10,1 240.47,1 242.43,+1.96,"Close long position for symbol BYBIT:APEUSDT at price 6.778 for 40 shares. Position AVG Price was 6.729000, currency: USDT, rate: 1.000160, last updated rate on 2022-08-10T08:07:00Z, point value: 1.000000"
2022-08-10 10:43:38,1 238.31,1 240.47,+2.16,"Close long position for symbol BYBIT:APEUSDT at price 6.756 for 80 shares. Position AVG Price was 6.729000, currency: USDT, rate: 1.000160, last updated rate on 2022-08-10T08:07:00Z, point value: 1.000000"
2022-08-10 10:21:18,1 238.47,1 238.31,-0.16,"Close short position for symbol BYBIT:APEUSDT at price 6.706 for 160 shares. Position AVG Price was 6.705000, currency: USDT, rate: 1.000160, last updated rate on 2022-08-10T08:07:00Z, point value: 1.000000"
2022-08-10 08:48:30,1 240.55,1 238.47,-2.08,"Close short position for symbol BYBIT:APEUSDT at price 6.711 for 80 shares. Position AVG Price was 6.685000, currency: USDT, rate: 1.000360, last updated rate on 2022-08-10T06:04:00Z, point value: 1.000000"
2022-08-09 16:08:44,1 235.26,1 240.55,+5.29,"Close short position for symbol BYBIT:APEUSDT at price 6.812 for 30 shares. Position AVG Price was 6.988333, currency: USDT, rate: 1.000170, last updated rate on 2022-08-09T13:07:01Z, point value: 1.000000"
2022-08-09 16:07:55,1 231.11,1 235.26,+4.15,"Close short position for symbol BYBIT:APEUSDT at price 6.850 for 30 shares. Position AVG Price was 6.988333, currency: USDT, rate: 1.000170, last updated rate on 2022-08-09T13:07:01Z, point value: 1.000000"
2022-08-09 16:01:44,1 226.46,1 231.11,+4.64,"Close short position for symbol BYBIT:APEUSDT at price 6.911 for 60 shares. Position AVG Price was 6.988333, currency: USDT, rate: 1.000170, last updated rate on 2022-08-09T13:07:01Z, point value: 1.000000"
2022-08-09 15:59:16,1 222.58,1 226.46,+3.88,"Close short position for symbol BYBIT:APEUSDT at price 6.956 for 120 shares. Position AVG Price was 6.988333, currency: USDT, rate: 1.000170, last updated rate on 2022-08-09T13:07:01Z, point value: 1.000000"
2022-08-09 15:53:35,1 225.22,1 222.58,-2.64,"Close long position for symbol BYBIT:APEUSDT at price 7.045 for 160 shares. Position AVG Price was 7.061500, currency: USDT, rate: 1.000170, last updated rate on 2022-08-09T13:07:01Z, point value: 1.000000"
2022-08-09 15:51:34,1 228.02,1 225.22,-2.80,"Close long position for symbol BYBIT:APEUSDT at price 7.065 for 160 shares. Position AVG Price was 7.082500, currency: USDT, rate: 1.000170, last updated rate on 2022-08-09T13:07:01Z, point value: 1.000000"
2022-08-09 15:42:06,1 230.75,1 228.02,-2.72,"Close short position for symbol BYBIT:APEUSDT at price 7.099 for 160 shares. Position AVG Price was 7.082000, currency: USDT, rate: 1.000170, last updated rate on 2022-08-09T13:07:01Z, point value: 1.000000"
2022-08-09 15:36:46,1 231.15,1 230.75,-0.40,"Close long position for symbol BYBIT:APEUSDT at price 7.082 for 160 shares. Position AVG Price was 7.084500, currency: USDT, rate: 1.000170, last updated rate on 2022-08-09T13:07:01Z, point value: 1.000000"
2022-08-09 15:31:10,1 232.11,1 231.15,-0.96,"Close long position for symbol BYBIT:APEUSDT at price 7.072 for 80 shares. Position AVG Price was 7.084000, currency: USDT, rate: 1.000170, last updated rate on 2022-08-09T13:07:01Z, point value: 1.000000"
2022-08-09 14:05:26,1 233.95,1 232.11,-1.84,"Close short position for symbol BYBIT:APEUSDT at price 7.056 for 80 shares. Position AVG Price was 7.033000, currency: USDT, rate: 1.000060, last updated rate on 2022-08-09T11:09:03Z, point value: 1.000000"
2022-08-09 14:00:13,1 234.99,1 233.95,-1.04,"Close long position for symbol BYBIT:APEUSDT at price 7.033 for 80 shares. Position AVG Price was 7.046000, currency: USDT, rate: 1.000060, last updated rate on 2022-08-09T11:09:03Z, point value: 1.000000"
2022-08-09 13:58:11,1 232.75,1 234.99,+2.24,"Close short position for symbol BYBIT:APEUSDT at price 7.046 for 80 shares. Position AVG Price was 7.074000, currency: USDT, rate: 1.000060, last updated rate on 2022-08-09T11:09:03Z, point value: 1.000000"
2022-08-09 13:49:18,1 227.95,1 232.75,+4.80,"Close short position for symbol BYBIT:APEUSDT at price 7.014 for 80 shares. Position AVG Price was 7.074000, currency: USDT, rate: 1.000060, last updated rate on 2022-08-09T11:09:03Z, point value: 1.000000"
2022-08-09 13:41:20,1 227.31,1 227.95,+0.64,"Close long position for symbol BYBIT:APEUSDT at price 7.074 for 160 shares. Position AVG Price was 7.070000, currency: USDT, rate: 1.000060, last updated rate on 2022-08-09T11:09:03Z, point value: 1.000000"
2022-08-09 13:26:20,1 227.39,1 227.31,-0.08,"Close long position for symbol BYBIT:APEUSDT at price 7.062 for 160 shares. Position AVG Price was 7.062500, currency: USDT, rate: 1.000060, last updated rate on 2022-08-09T11:09:03Z, point value: 1.000000"
2022-08-09 13:04:38,1 230.35,1 227.39,-2.96,"Close short position for symbol BYBIT:APEUSDT at price 7.069 for 160 shares. Position AVG Price was 7.050500, currency: USDT, rate: 1.000060, last updated rate on 2022-08-09T10:09:00Z, point value: 1.000000"
2022-08-09 12:59:19,1 232.59,1 230.35,-2.24,"Close long position for symbol BYBIT:APEUSDT at price 7.039 for 80 shares. Position AVG Price was 7.067000, currency: USDT, rate: 1.000060, last updated rate on 2022-08-09T10:09:00Z, point value: 1.000000"
2022-08-09 12:42:41,1 232.15,1 232.59,+0.44,"Close short position for symbol BYBIT:APEUSDT at price 7.043 for 60 shares. Position AVG Price was 7.050333, currency: USDT, rate: 1.000060, last updated rate on 2022-08-09T10:09:00Z, point value: 1.000000"
2022-08-09 12:41:19,1 231.29,1 232.15,+0.86,"Close short position for symbol BYBIT:APEUSDT at price 7.036 for 60 shares. Position AVG Price was 7.050333, currency: USDT, rate: 1.000060, last updated rate on 2022-08-09T10:09:00Z, point value: 1.000000"
2022-08-09 12:31:35,1 229.25,1 231.29,+2.04,"Close short position for symbol BYBIT:APEUSDT at price 7.038 for 40 shares. Position AVG Price was 7.089000, currency: USDT, rate: 1.000060, last updated rate on 2022-08-09T10:09:00Z, point value: 1.000000"
2022-08-09 11:59:31,1 224.12,1 229.25,+5.12,"Close short position for symbol BYBIT:APEUSDT at price 7.092 for 80 shares. Position AVG Price was 7.156000, currency: USDT, rate: 1.000250, last updated rate on 2022-08-09T09:06:17Z, point value: 1.000000"
2022-08-09 11:55:01,1 219.08,1 224.12,+5.04,"Close short position for symbol BYBIT:APEUSDT at price 7.093 for 80 shares. Position AVG Price was 7.156000, currency: USDT, rate: 1.000250, last updated rate on 2022-08-09T09:06:17Z, point value: 1.000000"
2022-08-09 11:43:23,1 215.08,1 219.08,+4.00,"Close short position for symbol BYBIT:APEUSDT at price 7.132 for 80 shares. Position AVG Price was 7.182000, currency: USDT, rate: 1.000250, last updated rate on 2022-08-09T09:06:17Z, point value: 1.000000"
2022-08-09 11:41:16,1 215.64,1 215.08,-0.56,"Close long position for symbol BYBIT:APEUSDT at price 7.182 for 160 shares. Position AVG Price was 7.185500, currency: USDT, rate: 1.000250, last updated rate on 2022-08-09T09:06:17Z, point value: 1.000000"
2022-08-09 11:32:42,1 215.20,1 215.64,+0.44,"Close short position for symbol BYBIT:APEUSDT at price 7.183 for 120 shares. Position AVG Price was 7.186667, currency: USDT, rate: 1.000250, last updated rate on 2022-08-09T09:06:17Z, point value: 1.000000"
2022-08-09 11:22:27,1 213.16,1 215.20,+2.04,"Close short position for symbol BYBIT:APEUSDT at price 7.195 for 40 shares. Position AVG Price was 7.246000, currency: USDT, rate: 1.000250, last updated rate on 2022-08-09T09:06:17Z, point value: 1.000000"
2022-08-09 11:07:26,1 210.08,1 213.16,+3.08,"Close short position for symbol BYBIT:APEUSDT at price 7.247 for 120 shares. Position AVG Price was 7.272667, currency: USDT, rate: 1.000260, last updated rate on 2022-08-09T08:08:13Z, point value: 1.000000"
2022-08-09 10:46:43,1 206.28,1 210.08,+3.80,"Close short position for symbol BYBIT:APEUSDT at price 7.241 for 120 shares. Position AVG Price was 7.272667, currency: USDT, rate: 1.000260, last updated rate on 2022-08-09T08:08:13Z, point value: 1.000000"
2022-08-09 10:37:14,1 207.88,1 206.28,-1.60,"Close long position for symbol BYBIT:APEUSDT at price 7.269 for 160 shares. Position AVG Price was 7.279000, currency: USDT, rate: 1.000260, last updated rate on 2022-08-09T08:08:13Z, point value: 1.000000"
2022-08-08 22:08:26,1 210.44,1 207.88,-2.56,"Close short position for symbol BYBIT:APEUSDT at price 7.334 for 160 shares. Position AVG Price was 7.318000, currency: USDT, rate: 1.000290, last updated rate on 2022-08-08T19:08:06Z, point value: 1.000000"
2022-08-08 21:26:48,1 212.52,1 210.44,-2.08,"Close short position for symbol BYBIT:APEUSDT at price 7.310 for 160 shares. Position AVG Price was 7.297000, currency: USDT, rate: 1.000290, last updated rate on 2022-08-08T19:08:06Z, point value: 1.000000"
2022-08-08 20:07:23,1 213.56,1 212.52,-1.04,"Close short position for symbol BYBIT:APEUSDT at price 7.328 for 80 shares. Position AVG Price was 7.315000, currency: USDT, rate: 1.000080, last updated rate on 2022-08-08T17:09:09Z, point value: 1.000000"
2022-08-08 20:04:45,1 217.48,1 213.56,-3.92,"Close long position for symbol BYBIT:APEUSDT at price 7.318 for 160 shares. Position AVG Price was 7.342500, currency: USDT, rate: 1.000080, last updated rate on 2022-08-08T17:09:09Z, point value: 1.000000"
2022-08-08 19:40:38,1 217.32,1 217.48,+0.16,"Close long position for symbol BYBIT:APEUSDT at price 7.332 for 80 shares. Position AVG Price was 7.330000, currency: USDT, rate: 1.000080, last updated rate on 2022-08-08T17:09:09Z, point value: 1.000000"
2022-08-08 19:36:39,1 216.92,1 217.32,+0.40,"Close long position for symbol BYBIT:APEUSDT at price 7.328 for 80 shares. Position AVG Price was 7.323000, currency: USDT, rate: 1.000080, last updated rate on 2022-08-08T17:09:09Z, point value: 1.000000"
2022-08-08 19:20:55,1 216.92,1 216.92,0.00,"Close long position for symbol BYBIT:APEUSDT at price 7.321 for 80 shares. Position AVG Price was 7.321000, currency: USDT, rate: 1.000080, last updated rate on 2022-08-08T17:09:09Z, point value: 1.000000"
2022-08-08 18:49:44,1 214.60,1 216.92,+2.32,"Close long position for symbol BYBIT:APEUSDT at price 7.298 for 80 shares. Position AVG Price was 7.269000, currency: USDT, rate: 1.000090, last updated rate on 2022-08-08T16:08:28Z, point value: 1.000000"
2022-08-08 18:32:25,1 212.64,1 214.60,+1.96,"Close short position for symbol BYBIT:APEUSDT at price 7.259 for 40 shares. Position AVG Price was 7.308000, currency: USDT, rate: 1.000090, last updated rate on 2022-08-08T16:08:28Z, point value: 1.000000"
2022-08-08 18:20:47,1 210.12,1 212.64,+2.52,"Close short position for symbol BYBIT:APEUSDT at price 7.245 for 40 shares. Position AVG Price was 7.308000, currency: USDT, rate: 1.000090, last updated rate on 2022-08-08T16:08:28Z, point value: 1.000000"
2022-08-08 18:08:34,1 207.96,1 210.12,+2.16,"Close short position for symbol BYBIT:APEUSDT at price 7.281 for 80 shares. Position AVG Price was 7.308000, currency: USDT, rate: 1.000080, last updated rate on 2022-08-08T15:09:11Z, point value: 1.000000"
2022-08-08 18:01:31,1 208.12,1 207.96,-0.16,"Close long position for symbol BYBIT:APEUSDT at price 7.304 for 160 shares. Position AVG Price was 7.305000, currency: USDT, rate: 1.000080, last updated rate on 2022-08-08T15:09:11Z, point value: 1.000000"
2022-08-08 17:42:59,1 205.08,1 208.12,+3.04,"Close short position for symbol BYBIT:APEUSDT at price 7.290 for 40 shares. Position AVG Price was 7.366000, currency: USDT, rate: 1.000080, last updated rate on 2022-08-08T15:09:11Z, point value: 1.000000"
2022-08-08 17:39:08,1 202.00,1 205.08,+3.08,"Close short position for symbol BYBIT:APEUSDT at price 7.289 for 40 shares. Position AVG Price was 7.366000, currency: USDT, rate: 1.000080, last updated rate on 2022-08-08T15:09:11Z, point value: 1.000000"
2022-08-08 17:26:39,1 200.00,1 202.00,+2.00,"Close short position for symbol BYBIT:APEUSDT at price 7.341 for 80 shares. Position AVG Price was 7.366000, currency: USDT, rate: 1.000080, last updated rate on 2022-08-08T15:09:11Z, point value: 1.000000"